111111111111111111111111111111111111111111111111111111111111
1P000000000000000000000000010000000000000000000000000000C001
100000000000000000000000000100000000000000000000000000000001
1000000000C000000000000000010000000000000CCCCCCCC00000000001
100000000000X00X00000000000100000000000000000000000000000001
100000000100000000000000000100000000000000000000000000000001
1000000000C0000000000000000000000000000001000C00000000000001
100000000000000000000000000000000000000001000000000000000001
1000000000000000000000000000000000000C0001000000000000000001
1E000000000000000000000000000000000XXXX001000000000000000001
111111111111111111111111111111111111111111111111111111111111
