111111111111111111111111111111111111111
1E0011111111000C00000C0000000000000C001
101001010010000010100100000001010110111
101001001010101000100100000C01010110001
1P0000000C00C0000000000000000000C11E101
111111111111111111111111111111111111111