111111
1E0101
10C001
1P0011
111111