11111111
101110P1
1E111111
11111111