111111111111111111111111111111111111111111111111111111111111
1P0000000000000000000000000100000000000000000X0000000000C001
100000000000000000000000000100000000000000000000000000000001
1000000000C0000000X0000000010000000000000CCCCCCCC00000000001
100000000000000000000000000100000000000000000000000000000001
100000000100000000X00000000100000000000000000000000000000001
1000000000C0000000000000000000000000000001000C00000000000001
10000000000000000000X00000000000X000000001000000000000000001
1000000000000XXXX00000000XX0000000000C0001000000000000000001
1E0000000000000000000000000000000000000001000000000X00000001
111111111111111111111111111111111111111111111111111111111111